0	1
Decker-Anderson	Integrated methodical contingency for integrate impactful vortals
Baxter-Pena	Front-line object-oriented knowledgebase for streamline integrated metrics
Madden-Torres	Multi-lateral multi-tasking database for strategize real-time models
Dunn LLC	Compatible clear-thinking database for morph efficient web services
Berger-Jackson	Programmable hybrid adapter for implement visionary e-business
Herring, Estes and Murray	Face-to-face dedicated application for grow open-source platforms
Graham LLC	Focused encompassing function for exploit mission-critical interfaces
Walton Ltd	Synergistic global flexibility for deliver collaborative deliverables
Dominguez PLC	Adaptive analyzing data-warehouse for morph frictionless applications
Flores-Davis	Configurable zero administration complexity for re-contextualize visionary technologies
Harding, Nichols and Berry	Synergized solution-oriented encoding for visualize intuitive networks
Gill and Sons	Mandatory 4thgeneration capability for visualize rich synergies
Brewer, Jarvis and Butler	Reverse-engineered asymmetric budgetary management for whiteboard distributed channels
Gaines-Brooks	Reverse-engineered impactful model for aggregate intuitive deliverables
Steele Ltd	Grass-roots homogeneous artificial intelligence for incubate proactive markets
Smith and Sons	Team-oriented tangible projection for matrix cutting-edge convergence
Douglas and Sons	Progressive asynchronous definition for orchestrate revolutionary ROI
Walton, Wilson and Johnson	Progressive optimal paradigm for empower innovative e-markets
Davis-Morgan	Automated zero-defect knowledgebase for engineer cutting-edge content
Williams, Smith and Quinn	Face-to-face demand-driven service-desk for iterate strategic bandwidth
Perkins-Ford	Focused national intranet for matrix mission-critical web services
Hanson, Mullen and Lewis	Up-sized multimedia groupware for expedite enterprise eyeballs
Zamora Group	Balanced well-modulated matrix for expedite magnetic communities
Carter, Brown and Richard	Mandatory interactive throughput for productize value-added applications
Anderson, Contreras and Noble	Object-based leadingedge portal for maximize magnetic schemas
Wood, Wells and Smith	Decentralized system-worthy projection for orchestrate robust paradigms
Davis, Bowman and Carter	Function-based value-added concept for engineer ubiquitous schemas
Owens and Sons	Adaptive responsive productivity for whiteboard revolutionary initiatives
Combs Group	Self-enabling executive software for extend user-centric partnerships
Montgomery-Harris	Up-sized context-sensitive hierarchy for optimize leading-edge methodologies
Joseph, Chambers and Reid	Profound secondary knowledge user for strategize value-added methodologies
Jones-Baldwin	Synergized secondary utilization for enhance strategic bandwidth
Hudson-Harris	Distributed responsive synergy for exploit value-added platforms
Young Inc	Right-sized multi-tasking monitoring for synthesize one-to-one e-commerce
Newman Inc	Ergonomic 3rdgeneration pricing structure for aggregate impactful supply-chains
Taylor, Solis and Wagner	Synergized bi-directional system engine for drive B2B users
Short LLC	Total mission-critical firmware for seize bleeding-edge mindshare
Merritt LLC	Self-enabling local leverage for seize intuitive functionalities
Wallace-Hernandez	Programmable client-driven emulation for leverage cross-media channels
Giles Inc	Future-proofed mobile website for grow wireless content
Kline, Garcia and Patterson	Multi-tiered bifurcated product for benchmark real-time platforms
Henderson-Perry	Function-based transitional core for syndicate best-of-breed models
Guerrero, Jones and Spencer	Versatile cohesive moderator for transform rich deliverables
Cruz Inc	User-friendly contextually-based orchestration for optimize bricks-and-clicks methodologies
Evans-Rosales	Stand-alone bifurcated instruction set for e-enable wireless e-commerce
Farmer-Moore	Pre-emptive multi-state circuit for deliver 24/7 info-mediaries
Mccall, Olson and Porter	Realigned incremental projection for grow dot-com communities
Bennett-Finley	Triple-buffered eco-centric access for visualize end-to-end convergence
Bishop, Harrington and Atkins	Adaptive logistical project for embrace cutting-edge deliverables
